9 9
2 4 2 4 2 4 2 4 2 
4 1 1 1 1 1 1 1 4 
2 1 2 0 0 4 5 1 2 
4 1 0 1 1 1 4 1 4 
2 1 0 0 2 0 0 1 2 
4 1 0 1 0 1 0 1 4 
2 1 3 0 0 0 2 1 2 
4 1 1 1 1 1 1 1 4 
2 4 2 4 2 4 2 4 2 
