13 13
5 7 4 2 7 4 2 7 4 2 7 4 2 
1 1 1 1 1 1 1 1 1 1 1 1 7 
4 2 4 1 4 2 4 1 4 2 4 1 4 
6 1 6 2 6 1 6 2 6 1 6 2 6 
4 1 4 6 4 1 4 6 4 1 4 6 4 
6 1 1 1 1 1 1 1 1 1 1 1 1 
4 1 4 6 4 1 4 6 4 1 4 0 4 
6 1 6 1 6 1 6 1 6 1 6 1 6 
4 6 4 1 4 6 4 1 4 6 4 1 4 
1 1 1 1 1 1 1 1 1 1 1 1 6 
6 6 6 1 4 6 4 1 4 6 4 1 4 
6 1 7 1 7 1 7 1 7 1 7 1 7 
3 1 4 6 4 1 4 6 4 1 4 6 4 
