12 12
0 0 0 0 0 0 0 0 2 0 0 2 
0 0 1 1 4 1 1 1 1 1 1 0 
1 0 0 1 4 4 1 4 1 4 1 4 
0 0 0 1 0 0 2 0 0 2 0 2 
0 1 1 1 4 0 0 1 4 1 4 0 
0 0 0 1 4 1 1 1 1 1 1 0 
1 0 1 1 4 0 4 0 4 0 1 4 
4 2 1 0 0 0 0 2 1 1 1 2 
4 4 1 1 1 1 0 1 1 1 1 0 
4 4 2 4 5 1 2 0 0 0 0 0 
1 1 1 1 1 1 1 0 1 0 1 0 
3 0 0 0 0 0 0 0 0 0 0 0 
