9 5
1 4 2 4 5 4 2 4 1 
1 4 2 4 4 4 2 4 1 
1 4 2 2 2 2 2 4 1 
1 7 0 0 0 0 0 7 1 
1 1 0 0 3 0 0 1 1 
